AGCGCTAG
CCAACAGA
ATATTCAC
AACCGCGG
CCTGAACT
CTGTATTA
ATCTTAGT
CCTCGGTA
GATATCGA
TTGGTGAG
GCGCCTGT
GGTTATAA
TTCAGGTC
TCACGCCG
GCTCCGAC
TTCTAACG
CGCAGACG
CGCGGTTC
ACTCTATG
CCAAGTCC
AGTAGAGA
ACTTACAT
ATACCAAG
ATGAGGCT
TATGAGTA
TATAACCT
GTCTCGCA
TTGGACTT
GACGAGAG
GTCCGTGC
GCGTTGGA
GCAGAATC
